########
#   .  #
# .# $ #
#  $   #
#  @   #
########
