#########
#      .#
#  # ####
#  $    #
#  #  ###
# # #   #
#  @    #
#########