########
#     .#
#  # ###
#  $   #
#  @   #
########
