###############
#### #   # ####
###  #$#.$  ###
## $ # #.#   ##
## $ # #.#   ##
#  $ # #.##   #
#  $ # #.#    #
## $ # #.### ##
## $   #.#   ##
##   # #.#   ##
###$#   @   ###
###   ##.#  ###
####    #  ####
###############