######
#    #
# #  #
#*$ .#
#@####
# ####
######