##########
####   ###
####@$  ##
####$$$  #
#### $ $ #
#### $$  #
#### $  ##
#### #####
#### ..###
#### ..###
#### .####
#### ..###
#    ..###
# # $.####
#   ######
##########
